,Details,Posting Date,Description,Amount,Type,Balance,Check or Slip #,Unnamed: 7,Unnamed: 8
3,CREDIT,2025-07-31,PAYROLL ST OF CA CA PAYROLL                 PPD ID: 9111113698,3088.87,ACH_CREDIT,3395.39,,,
4,DEBIT,2025-07-14,CHASE CREDIT CRD AUTOPAY                    PPD ID: 4760039224,-15.2,ACH_DEBIT,306.52,,,
5,DEBIT,2025-07-08,Online Transfer to  SAV ...9000 transaction#: 25033139293,-500.0,ACCT_XFER,321.72,,,
6,CREDIT,2025-07-03,Zelle payment from Nazmul Muzahid USB56txnK5qb,18.0,PARTNERFI_TO_CHASE,821.72,,,
7,DEBIT,2025-07-01,Zelle payment to Juancho 25328735128,-3000.0,QUICKPAY_DEBIT,803.72,,,
8,CREDIT,2025-07-01,PAYROLL ST OF CA CA PAYROLL                 PPD ID: 9111113698,3088.87,ACH_CREDIT,3803.72,,,
