,Details,Posting Date,Description,Amount,Type,Balance,Check or Slip #,Unnamed: 7,Unnamed: 8
9,DEBIT,2025-06-12,Payment to Chase card ending in 4009 06/12,-90.28,LOAN_PMT,714.85,,,
10,CREDIT,2025-06-12,Zelle payment from Alexis Saldivar Garcia USBMyhBnE80w,21.5,PARTNERFI_TO_CHASE,805.13,,,
11,DEBIT,2025-06-06,Online Transfer to  SAV ...9000 transaction#: 24691183621,-500.0,ACCT_XFER,783.63,,,
12,DEBIT,2025-06-03,Zelle payment to Juancho 25000140228,-5000.0,QUICKPAY_DEBIT,1283.63,,,
13,DEBIT,2025-06-02,DOMESTIC INCOMING WIRE FEE,-15.0,FEE_TRANSACTION,6283.63,,,
14,DEBIT,2025-06-02,Zelle payment to Juancho 24986836214,-5000.0,QUICKPAY_DEBIT,6298.63,,,
15,DEBIT,2025-06-02,Zelle payment to Juancho 24974557197,-3000.0,QUICKPAY_DEBIT,11298.63,,,
16,CREDIT,2025-06-02,PAYROLL ST OF CA CA PAYROLL                 PPD ID: 9111113698,3088.87,ACH_CREDIT,14298.63,,,
17,CREDIT,2025-06-02,"FEDWIRE CREDIT VIA: THE BANK OF NEW YORK MELLON/021000018 B/O: 1/GEORGINA GABRIELA CANTO ENCALA 3/MX/MEXICO REF: CHASE NYC/CTR/BNF=GEORGINA GABRIELA CANTO ENCALADA SAN DIEGO CA 92108- 1559 US/AC-000000005198 RFB=O/B BK OF NYC OBI=RENTA BBI=/CHGS/USD0,00/OCMT/MXN180000,0/EXCH/19,84314/BNF/LESS FEES IMAD: 0602B1Q8152C000380 TRN: 0050521153FF",9061.14,WIRE_INCOMING,11209.76,,,
