,Details,Posting Date,Description,Amount,Type,Balance,Check or Slip #,Unnamed: 7,Unnamed: 8
347,DEBIT,2023-08-29,SD GAS & ELEC    PAID SDGE                  PPD ID: 1951184800,-31.56,ACH_DEBIT,4917.48,,,
348,DEBIT,2023-08-24,COSTCO GAS #0488 SAN DIEGO CA        615294  08/24,-46.57,DEBIT_CARD,4949.04,,,
349,DEBIT,2023-08-23,CHASE CREDIT CRD AUTOPAY                    PPD ID: 4760039224,-156.32,ACH_DEBIT,4995.61,,,
350,DEBIT,2023-08-14,COSTCO GAS #0488 SAN DIEGO CA        854845  08/13,-30.7,DEBIT_CARD,5151.93,,,
351,DEBIT,2023-08-09,Zelle payment to FISHERTRANS LLC JPM99a0hau6b,-516.55,CHASE_TO_PARTNERFI,5182.63,,,
352,CREDIT,2023-08-09,Zelle payment from DEBRA GOSSMAN 18122526117,875.0,QUICKPAY_CREDIT,5699.18,,,
353,DEBIT,2023-08-08,SD GAS & ELEC    PAID SDGE                  PPD ID: 1951184800,-193.18,ACH_DEBIT,4824.18,,,
354,DEBIT,2023-08-07,COSTCO GAS #0488 SAN DIEGO CA        831745  08/05,-43.11,DEBIT_CARD,5017.36,,,
